Blvl 42
desc Animation-test level
time 999
points 50
color 1
start  3  4 +1
level 15 11
.1.2.3.4.5.6..*
...............
...............
...............
.#.#.#.#.#.#...
...............
..a.b.c.d.e.f..
...............
...............
..A.B.C.D.E.F..
..............a
