Blvl 42
desc Original Level #03
time 799
points 39
color 5
start  3  5 +1
level 15 11
*e*e*e*e*e*e*e*
.e.e.e.e.e.e.e.
...e.e.e.e.e...
.e...e.e.e...e.
.e.e...e...e.e.
.e.e.e...e.e.e.
.e.e...e...e.e.
.e...e.e.e...e.
...e.e.e.e.e...
.e.e.e.e.e.e.e.
.e.e.e.e.e.e.e.
