Clvl 42
desc Original Level #3
start 3 5 +1 1
time 799
level 15 11
*a*a*a*a*a*a*a*
.a.a.a.a.a.a.a.
...a.a.a.a.a...
.a...a.a.a...a.
.a.a...a...a.a.
.a.a.a...a.a.a.
.a.a...a...a.a.
.a...a.a.a...a.
...a.a.a.a.a...
.a.a.a.a.a.a.a.
.a.a.a.a.a.a.a.
