Blvl 42
desc Original Level #05
time 799
points 50
color 1
start  3  4 +1
level 15 11
.....A..*...aaa
.....#......aa3
...A.#c.....aaa
###.###########
...............
.c.ccc.ccc.ccc.
.c.c.c.c.c.a.c.
.c.ccc.ccc.aac.
.c...c.c.c.a.c.
.c...c.ccc.aac.
...............
