Blvl 42
desc Original Level #07
time 499
points 147
color 1
start 24 20 +1
level 15 11
*5..........e.e
**.........e.5.
***.........e.e
****.......e.e.
**.**.......e.e
.*****.....e.e.
***.***.....e.e
*****.**...e.e.
*.*******...e.e
***.**.***.....
***********....
