Blvl 42
desc Original Level #08
time 999
points 63
color 3
start 15 11 +1
level 15 11
....3.......ddb
....3.2.....ddb
....#####...ddd
....#.#.#...dbd
....#.#.#...bbb
....#.#.#...bdd
#**C..#.#...bdb
........#...bbb
ff6f........ddd
..c.........dbb
4ccc........dbc
