Blvl 42
desc Original Level #09
time 599
points 125
color 4
start 27  3 +1
level 15 11
...............
........d.....d
...d.......d.dd
.ddd.d.....d.##
...d.......d...
.DDDDDDDDDDDDDD
...............
.#.#.#.#.#.#.#.
.#.#.#.#.#.#.#.
.6.3.1.3.5.2.4.
.#f#c#a#c#e#b#d
