Clvl 42
desc Original Level #9
start 27 2 +1 4
time 599
level 15 11
...............
........d.....d
...d.......d.dd
.ddd.d.....d.##
...d.......d...
.DDDDDDDDDDDDDD
...............
.#.#.#.#.#.#.#.
.#.#.#.#.#.#.#.
.5.2.3.2.1.6.4.
.#e#b#c#b#a#f#d
