Blvl 42
desc Original Level #10
time 699
points 255
color 5
start  2  9 +1
level 15 11
aE...E...E...E1
.E.E.E.E.E.E.E.
.E.E.E.E.E.E.E.
.E.E.E.E.E.E.E.
.E.E.E.E.E.E.E.
.E.E.E.E.E.E.E.
.E.E.E.E.E.E.E.
.E.E.E.E.E.E.E.
.E.E.E.E.E.E.E.
.E.E.E.E.E.E.E.
...E...E...E...
