Blvl 42
desc Original Level #12
time 999
points 79
color 1
start  2  5 +1
level 15 11
b.....b..b.....
....b.bb.......
..b.b.b..b...b.
..b......b.bb2.
b.b.b.bb.b...b.
..b.b.b..b...b.
.Ab.b.b..b...b.
..b.b.b..bb..b.
.bb.b.b......b.
.b....b..b..bb.
......b..bb..b*
