Blvl 42
desc Original Level #14
time 699
points 208
color 4
start 26 15 +1
level 15 11
#.#.#.#.#.#.#.#
.DdDdDdDdDdDdD.
#.#.#.#.#.#.#.#
.D.D.D.D.D.D.D.
#.#.#.#.#.#.#.#
.D.D.D.D.D.D.D.
#.#.#.#.#.#.#.#
.D.D.D.D.D.D.D.
#.#.#.#.#.#.#.#
.DdDdDdDdDdDdD.
#.#.#.#.#.#.#.#
