Blvl 42
desc Original Level #18
time 999
points 93
color 4
start 29  9 +1
level 15 11
..*...5..*...*.
..1...*..2...6.
....3......4...
....*......*...
#############..
..E....C....A..
#...##...##...#
##.####.####.##
f#ff#b#bb#d#dd#
f#Ff#b#Bb#d#Dd#
ffff#bbbb#dddd#
