Blvl 42
desc Original Level #19
time 599
points 208
color 2
start  4  1 +1
level 15 11
...............
.BBB..BBB.B.BB.
.BBBBB..BB.BBB.
.BBBB.BBBB.BB..
..BB....BB.BB.B
B.B.B.B.B...BB.
BBBB.BBBB.B.BB.
B..B.BBBB..B.BB
B.BBBBBBBBB.BBB
...............
e5eeeeee55eeeee
