Blvl 42
desc Original Level #22
time 599
points 108
color 3
start 15 11 +1
level 15 11
***************
...............
...............
.####...#..#...
.#..#...#..#...
.c..c...c.c....
.c..c...cc.....
.c..c...c.c....
.5..e...e..e...
.eeee.e.e..e.e.
...............
