Blvl 42
desc Original Level #24
time 999
points 212
color 4
start 10  8 +1
level 15 11
..f#2..#a..#...
...#c..#...E...
E####D#######E#
.5.d...#...#...
...#...D...D..d
#E###D###D###D#
...#...#...#...
...#e..#...#...
#.####D#f####1#
a.a#...B...C...
3a.#...6.3c#ec5
