Clvl 42
desc Original Level #2
start 2 4 1 1
time 599
level 15 11
...............
...............
...............
...............
.1111111111111.
.#############.
...............
.3aaaaaaaaaaaa.
.##*##*##***##.
...............
...............
