Clvl 42
desc Original Level #5
start 3 4 +1 3
time 799
level 15 11
.....C..*...ccc
.....#......cc2
...C.#b.....ccc
###.###########
...............
.b.bbb.bbb.bbb.
.b.b.b.b.b.c.b.
.b.bbb.bbb.ccb.
.b...b.b.b.c.b.
.b...b.bbb.ccb.
...............
