Clvl 42
desc Original Level #7
start 24 19 +1 3
time 499
level 15 11
*1..........a.a
**.........a.1.
***.........a.a
****.......a.a.
**.**.......a.a
.*****.....a.a.
***.***.....a.a
*****.**...a.a.
*.*******...a.a
***.**.***.....
***********....
