Clvl 42
desc Original Level #8
start 15 11 +1 2
time 999
level 15 11
....2.......ddf
....2.6.....ddf
....#####...ddd
....#.#.#...dfd
....#.#.#...fff
....#.#.#...fdd
#**B..#.#...fdf
........#...fff
ee5e........ddd
..b.........dff
4bbb........dfb
