Clvl 42
desc Original Level #10
start 2 9 +1 1
time 599
level 15 11
cA...A...A...A3
.A.A.A.A.A.A.A.
.A.A.A.A.A.A.A.
.A.A.A.A.A.A.A.
.A.A.A.A.A.A.A.
.A.A.A.A.A.A.A.
.A.A.A.A.A.A.A.
.A.A.A.A.A.A.A.
.A.A.A.A.A.A.A.
.A.A.A.A.A.A.A.
...A...A...A...
