Clvl 42
desc "A Hard days work" <sec@42.org>
start 10 10 1 1
time 999
level 20 15
ccccccccccccccccccc*
#........B.........*
#1aaaaaaaa.........*
#..................*
#..................*
#..................*
...................*
............C.3....*
...................*
#.............C....*
#..................*
#..................*
#2bbbbbbbb.........*
#........A.........*
#..................*
